Level 3
7168
448
000000000000000000000000000000000000000000000000000000000000000000000000000000000000000000000000000000000000000000000000000000000000000000000000000000000000
000000000000000000000000000000000000000000000000000000000000000000000000000000000000000000000000000000000000000000000000000000000000000000000000000000000000
BBBBBBBBBBBBBBBBBBBBBBBBBBBBBBBBBBBBBBBBBBBBBBBBBBBBBBBBBBBBBBBBBBBBBBBBBBBBBBBBBBBBBBBBBBBBBBBBBBBBBBBBBBBBBBBBBBBBBBBBBBBBBBBBBBBBBBBBBBBBBBBBBBBBBBBBBBBB
BBBBBBBBBBBBBBBBBBBB0000000000000BBBBBBBBBBBBBBBBBBBBBBBBBBBBBBBBBBB00000000B0000000B00000000BBBBBBB0000000000000000000BBBBB00000000000000BB0000000000000000
BBBBBBBBBBBBBBBBBBBB0000000000000BBBBBBBBBBBBBBBBBBBBBBBBBBBBBBBBBBB00000000i0000000i00000000BBBBBBB0000000000000000000BBBBB00000000000000BB0000000000000000
0000000000000000000B0000000000000BBBBBBBBBBBBBBBBBBBBBBBBBBBBBBBBBBB0000000000000000000000000000000000000000000000000000000000000000000000BB0000000000000000
00M0000000000000000i000000p000000i00000000000i0000000000i000000i000000000000000000000000000000000000000i00i00i0000000000000000000llll00000000000000000000000
BBB000000000000000000000000000000000000000000000000000000000000000000000000000000000000000000000000000000000000000000000000000000000000000000000000000000000
BBBB0000000000000000000000000000000000000000000000000000000000000000000000000000000000000000000000000000000000000000000000000000000000000y000000000000000000
BBBBB00000000000000000000000000BBBBBBBBBBBBBBBBBBBBBBBBBBBBBBBBBBBBB0000i0000000i0000000i0000000000000i00i00i000000000000000000000000X000BBB0000000000000000
BBBBBBBBBBB00BBBBBBBBB000BiB000BBBBBBBBBBBBBBBBBBBBBBBBBBBBBBBBBBBBBBBBBBBBBBBBBBBBBBBBBBBBBBBBBBBBB000000000000BBBB000BBBBBnnnnnnnnnnnnnBBB0000000000000000
BBBBBBBBBBB00BBBBBBBBB000BBB000BBBBBBBBBBBBBBBBBBBBBBBBBBBBBBBBBBBBBBBBBBBBBBBBBBBBBBBBBBBBBBBBBBBBB000000000000BBBB000BBBBB0000000000000BBB0000000000000000
BBBBBBBBBBBAABBBBBBBBB000BBB000BBBBBBBBBBBBBBBBBBBBBBBBBBBBBBBBBBBBBBBBBBBBBBBBBBBBBBBBBBBBBBBBBBBBB000000000000BBBB000BBBBB0000000000000BBB000000000r000000
BBBBBBBBBBB00BBBBBBBBBAAABBBAAABBBBBBBBBBBBBBBBBBBBBBBBBBBBBBBBBBBBBBBBBBBBBBBBBBBBBBBBBBBBBBBBBBBBBBBBBBBBBBBBBBBBBBBBBBBBBAAAAAAAAAAAAABBBBBBBBBBBBBBBBBBB
BBBBBBBBBBB00BBBBBBBBB000BBB000BBBBBBBBBBBBBBBBBBBBBBBBBBBBBBBBBBBBBBBBBBBBBBBBBBBBBBBBBBBBBBBBBBBBBBBBBBBBBBBBBBBBBBBBBBBBB0000000000000BBBBBBBBBBBBBBBBBBB

28
224 bloques horizontal

69 hasta el primer ABISMO
15 DESPUES DEL PRIMER ABISMO
65 DESPUES DEL SEGUNDO ABISMO
69 AL FINAL

r=princes
X= bosss
y= key
n: blocks platform
i :iron
A :Lava
L : Lava ball
l : platform
H : hidden block
T : Tube
p : Surprise block with power up
b : Brick UnderGround
B : stone_castle
E : star block
? : surprise block with coin
S : stair block
f : flag pole
F : flag
g : green circle
C : castle
c : coin
M : Mario